#################~~~~~~~~~~
#################    =~   #
     ~~~~    ==   =~==~   #
     ~~S~~  ====  ==~=~~  #
     ===~~   #==   =~=~~  #
     ===~~  ###    =~     #
     ===~~  ##   ###~     #
 =~              ## ~   ###
 =~      ##  == =~ =E   ###
      ==###  == =~      ###
##########   ==        ~###
~~~~~~~~         ~~~~##~   
 ### # # ### ### ====##=   
 # # # # #   # #   ==~~~=  
 ### # # #   ###   =~~~==  
 #   # # #   #     =##~    
 #   ### ### #     =##     
~~~~~~~~~~~~~~~~~~~~~~~~~~~