~~~~~~~~~~~~~~~~~~~
~~~~~~~~~~~~~~~~~~~
~~~~~          ~~~~
~~G~            ~~~
########   ~~~~~~~~
             ######
      S      #~~~~~
###### # #####~~~~~
     # #      ~~~~~
 # # ###### ####~~~
 #          #~~~~~~
     ### ####~~~~~~
                  I