###########################
###~~~~~~~~~~~~~~~~  ~~   #
#    ~### # # ### ###~~   #
#    ~# # # # # S # #~~~  #
#    ~### # # #   ###~~~  #
#    ~#   # # #   #       #
#    ~#   ### ### #       #
#                         #
#               ~         #
#       I      ~          #
# ~~~~ ~~~        ###     #
# ~  ~  ~                 #
# ~  ~  ~   ###           #
# ~~~~  ~                 #
# ~  ~  ~   ~~~~ ~   ~~~~ #
# ~  ~ ~~~  ~  ~ ~      ~ #
##########  ~  ~ ~     ~  #
#    ~      ~~~  ~    ~   #
#    ~~     ~ ~  ~    ~   #
#   ~~      ~  ~ ~   ~    #
#~  ~ ~ ~~  ~  ~ ~~~ ~~~~ #
#~       ~  ############# #
#                ~        #
#                ~        #
#      G       ~~         #
#               ~         #
~~~~~~~~~~~~~~~~~~~~~~~~~~~