#################~~~~~~~~~~
#################    ~~  I#
     ~~~~    ~~   ~~~~~   #
     ~~S~~  ~~~~  ~~~~~~  #
     ~~~~~   #~~   ~~~~~  #
     ~~~~~  ###    ~~     #
     ~~~~~  ##   ###~     #
 ~~              ## ~   ###
 ~~      ##  ~~ ~~ ~~   ###
      ~~###  ~~ ~~      ###
##########   ~ G   ~   ~###
~~~~~~~~         ~~~~##    
 ### # # ### ### ~~~~##~  ~
 # # # # #   # #   ~~~~~~  
 ### # # #   ###   ~~~~~~ ~
 #   # # #   #     ~##~    
 #   ### ### #     ~##    ~
~~~~~~~~~~~~~~~~~~~~~~~~~~~